############
#         O#
#   P   ####
#          #
#######    #
#    O##   #
#    ## X  O#
#           #
#    X     X #
#           #
#       #  #
############
